%%%%%%%%%%%%%
%   %%%   %%%
%S%     %   %
%%%%%% %% % %
%G        % %
%%%%%%%%%%%%%
